###                 #########
#   ###################   # #
# ####                # # # #
# ################### # # # #
#                     # # # #
##################### # # # #
#   ##                # # # #
# # ## ### ## ######### # # #
# #    #   ##B#         # # #
# # ## ###### ######### # # #
### ##             #### # # #
### ####### ###### ## # # # #
###             ##    # # # #
###### ######## ####### # # #
###### ####             #   #
A      ######################
